101,Harddisk,90,89,77,67,67,66,456,76
102,VGA Cable,89,89,78,90,79,66,491,81
103,HDMI Cable,89,90,66,55,88,78,466,77
104,Mouse,5100,9000,89,87,86,76,14438,2406
105,Keyboard,89,99,89,90,66,78,511,85
106,Joystick,90,98,97,94,44,56,479,79
107,Motherboard,78,89,76,56,33,56,388,64
108,Display,66,90,87,89,76,68,476,79
109,RAM,78,89,9,89,55,6,326,54
110,ROM,90,90,89,88,78,89,524,87
111,CPU,78,78,89,76,56,45,422,70
112,GPU,98,9,78,46,34,22,287,47
113,Charger,90,89,78,98,57,56,468,78
